111111111111111111111
1P00000C10101C00101C1
101111111010101010101
101000C01000101000001
101111101010111011101
100000000C1000C0100E1
111111111111111111111
