1111111111111111111111111
1P0010100000100000C000101
1011101011111110101111101
1000000000001000100010001
1110111010111011101110101
101010001C00001000C000101
101C111110101011101110111
1000001000101000101000001
111010111011C011101110111
101C101010001010000010001
1010111011101111101011111
1010000010100010101010001
1011101010111110111011101
100C0010001000C00000000E1
1111111111111111111111111
