1111111111111111111111111
1C001000100010000000000C1
1011101010111011111110101
1000101000001010000000101
1110111011101011111011101
101000100E101000101010001
1C10111110111110101011111
1010100010000000001010001
1010101110111111101110111
100000100000001P001000001
1C10101011111011101011111
1010101010001000100000001
10101010111010101111111C1
101C100010000C10000010001
1111111111111111111111111
