1111111111111111111111111
1000101000101010000010001
1110101011101010111110111
1010100010100C001C0000001
1010111010111011111011101
1000C01000001000001010101
1011111011101010101110101
10100000100E1P10101010101
1010101011111010111010101
10001010101000101C1010101
1110101010111010101010101
1010101000000010000010101
1010101111111011111010101
1000100C001000100C0000001
1111111111111111111111111
