1111111111111111111111111
1000000010001000101000001
11101111111C1110101011101
1000000010100000000010101
1110101110101110101110111
1010101000001010101000001
1010101110111010111010111
1P001010101C10001000101E1
1011111010101110111011101
10C01000C0101010001000101
1010101111101010101110101
1010001000000000101000001
1011101111101111101110111
1010000C1C0010000000000C1
1111111111111111111111111
