1111111111111111111111111
10000C10000C100010C0100P1
1011111010101011101010101
1C10100C10100000001010101
1C10111011111111101010101
1000000C000000C010100C101
1011101011111110111011101
1C001C101C1C1C100000100C1
111010111010101010111C111
10C01C00001000101000001E1
1010001111101011111011101
1010100C1C00101C000100101
1011111111101010110C11101
1C00000C000C100C001000001
1111111111111111111111111
