1111111111111111111111111
1000101C000010C0000000101
1110101011101111101111101
1010000C101010C0000010101
1011101110101011111010101
10101010C0001010001010101
1010101111111010111010101
1000C00000000010101000101
1011111111101010101010101
1010100000C0101C100010101
1010111110101110101110101
1010001C10101010001010101
1011101011101011111010101
1P000010000000000000100E1
1111111111111111111111111
