1111111111111111111111111
10000000100000001000000P1
1011111111111011111111101
1C10100000C000100000101C1
1010111011111011101110101
1000101000001010000000001
1C10101011101110111111101
1010001000101C00001010001
1111101111101110111010111
1C00100010100000100010101
10111011101C1110111011101
101000001C101010000000001
1011101110101011101111101
1000C000000000001010000E1
1111111111111111111111111
