1111111111111111111111111
1000000C101C0000101000001
1110101110101110101110111
1010100010100010101000101
1011101110101110101110101
1C10001000C01010001C00101
1010111011101011101011101
10101000101E000010C010001
1010101110111110111011101
1000100000001010001000001
1110111111101011111010101
1P10C00000001000000C10101
1010111011111110111111101
1000001010000000000C1C001
1111111111111111111111111
