1111111111111111111111111
1P100000000010000010000E1
1010111111101010101110111
1000001000000010100000001
1111101010111111101110111
10101010101010C0001000001
1010101011101111101111101
1000101000100000001010101
1011111010111111101010101
10001000101000C0001C00101
1011101110111111111011101
1010100C10000C10000010101
1010101110111010101110101
10000C1C00100000101C00001
1111111111111111111111111
