11111111111111111111111
1P0001010001100010000C1
11110000010C10100011101
10000101110010011001001
10010100001011001001101
1010010100C001001100001
10011101010100011100101
10000001010111000010111
110110100C0101110000001
10100010110100011110001
1C0010100C00010000C10E1
11111111111111111111111
