1111111111111111111111111
1E0000000000000C0C0000001
1010010100100000110010101
1010010010101010010010101
1P0000000C00C0000000000C1
1111111111111111111111111
